N N N N N N N N N N N N N N N N N N N N N N N N N N N N N N N N N N N N N N N N N N N N N N N N N N
N I B B B B B B B A N N N N N N N N N N N N N N N N N N N N N N N N N N N N N N I B B B B B B B A N
N Q J J J J J J J O N N N N N N N N N N N N N N N N N N N N N N N N N N N N N N Q J J J J J J J O N
N Q J L J J J L J O N N N N N N N N N N N N N N N N N N N N N N N N N N N N N N Q J L J J J L J O N
N Q J J J J J J J O N N N N N N N N N N N N N N N N N N N N N N N N N N N N N N Q J J J J J J J O N
N Q J J J J J J J O N N N N N N N N N N N N N N N N N N N N N N N N N N N N N N Q J J J J J J J O N
N Q J L J J J L J O N N N N N N N N N N N N N N N N N N N N N N N N N N N N N N Q J L J J J L J O N
N Q J J J J J J J O N N N N N N N N N N N N N N N N N N N N N N N N N N N N N N Q J J J J J J J O N
N G P P E J D P P H N N N N N N N N N N N N N N N N N N N N N N N N N N N N N N G P P E J D P P H N
N N N N Q J O N N N N N N N N N N N N N N N N N N N N N N N N N N N N N N N N N N N N Q J O N N N N
N I B B F J C B B B A N N N N N N N N N N N N N N N N N N N N N N N N N N N N I B B B F J C B B A N
N Q J J J J J J J J O N N N N N N N N N N N N N N N N N N N N N N N N N N N N Q J J J J J J J J O N
N Q J J J J J J J J O N N N N N N N N N N N N N N N N N N N N N N N N N N N N Q J J J J J J J J O N
N Q J J J J J J J J O N N N N N N N N N N N N N N N N N N N N N N N N N N N N Q J J J J J J J J O N
N Q J J J J J J J J O N N N N N N N N N N N N N N N N N N N N N N N N N N N N Q J J J J J J J J O N
N Q J J J J J J J J O N N N N N N N N N N N N I B B A N N N N N N N N N N N N Q J J J J J J J J O N
N Q J J J J J J J J O N N N N N I B B B B B B F J J C B B B B B B A N N N N N Q J J J J J J J J O N
N Q J J J J J J J J O N N N N N Q J J J J J J J J J J J J J J J J O N N N N N Q J J J J J J J J O N
N Q J J J J J J J J C B B B B B F J J J J J J K J J K J J J J J J C B B B B B F J J J J J J J J O N
N Q J J J J J J J J J J J J M J J J J J J J J J J J J J J J J J J J M J J J J J J J J J J J J J O N
N Q J J J J J J J J J J J J M J J J J J J J J J J J J J J J J J J J M J J J J J J J J J J J J J O N
N G P P P P P P P P P P P P P P E J J J J J J K J J K J J J J J J D P P P P P P P P P P P P P P H N
N N N N N N N N N N N N N N N N Q J J J J J J J J J J J J J J J J O N N N N N N N N N N N N N N N N
N N N N N N N N N N N N N N N N G P P P P P P E J J D P P P P P P H N N N N N N N N N N N N N N N N
N N N N N N N N N N N N N N N N N N N N N N N G P P H N N N N N N N N N N N N N N N N N N N N N N N
N N N N N N N N N N N N N N N N N N N N N N N N N N N N N N N N N N N N N N N N N N N N N N N N N N
N N N N N N N N N N N N N N N N N N N N N N N N N N N N N N N N N N N N N N N N N N N N N N N N N N
N N N N N N N N N N N N N N N N N N N N N N N N N N N N N N N N N N N N N N N N N N N N N N N N N N
N N N N N N N N N N N N N N N N N N N N N N N N N N N N N N N N N N N N N N N N N N N N N N N N N N
N N N N N N N N N N N N N N N N N N N N N N N N N N N N N N N N N N N N N N N N N N N N N N N N N N
N N N N N N N N N N N N N N N N N N N N N N N N N N N N N N N N N N N N N N N N N N N N N N N N N N
N N N N N N N N N N N N N N N N N N N N N N N N N N N N N N N N N N N N N N N N N N N N N N N N N N
N N N N N N N N N N N N N N N N N N N N N N N N N N N N N N N N N N N N N N N N N N N N N N N N N N
N N N N N N N N N N N N N N N N N N N N N N N N N N N N N N N N N N N N N N N N N N N N N N N N N N
N N N N N N N N N N N N N N N N N N N N N N N N N N N N N N N N N N N N N N N N N N N N N N N N N N
N N N N N N N N N N N N N N N N N N N N N N N N N N N N N N N N N N N N N N N N N N N N N N N N N N
N N N N N N N N N N N N N N N N N N N N N N N N N N N N N N N N N N N N N N N N N N N N N N N N N N
N N N N N N N N N N N N N N N N N N N N N N N N N N N N N N N N N N N N N N N N N N N N N N N N N N
N N N N N N N N N N N N N N N N N N N N N N N N N N N N N N N N N N N N N N N N N N N N N N N N N N
N N N N N N N N N N N N N N N N N N N N N N N N N N N N N N N N N N N N N N N N N N N N N N N N N N
N N N N N N N N N N N N N N N N N N N N N N N N N N N N N N N N N N N N N N N N N N N N N N N N N N
N N N N N N N N N N N N N N N N N N N N N N N N N N N N N N N N N N N N N N N N N N N N N N N N N N
N N N N N N N N N N N N N N N N N N N N N N N N N N N N N N N N N N N N N N N N N N N N N N N N N N
N N N N N N N N N N N N N N N N N N N N N N N N N N N N N N N N N N N N N N N N N N N N N N N N N N
N N N N N N N N N N N N N N N N N N N N N N N N N N N N N N N N N N N N N N N N N N N N N N N N N N
N N N N N N N N N N N N N N N N N N N N N N N N N N N N N N N N N N N N N N N N N N N N N N N N N N
N N N N N N N N N N N N N N N N N N N N N N N N N N N N N N N N N N N N N N N N N N N N N N N N N N
N N N N N N N N N N N N N N N N N N N N N N N N N N N N N N N N N N N N N N N N N N N N N N N N N N
N N N N N N N N N N N N N N N N N N N N N N N N N N N N N N N N N N N N N N N N N N N N N N N N N N
N N N N N N N N N N N N N N N N N N N N N N N N N N N N N N N N N N N N N N N N N N N N N N N N N N